to figure out - shoreline ("don't feed")
pick-up full of pink carnations - the vaccines ()
neck deep - neck deep ()
obsidian wraith - infant island ()
country - medium build ()
escape forever - soft kill ()
new last name - courting ()
head void - from indian lakes (the lines)
love hate music box - rainbow kitten surprise ()
a dream is all we know - the lemon twigs ()
shaboozey
ludowic
unto others
ghost dubs damaged
charlie crockett - visions of dallas
bad nerves - still nervous
moin
ultra q
golden brown
diiv - frog in boiling water
pedro the lion - santa cruz
earth tongue - great haunting
russian baths - mirror
the dangerous summer - gravity
suss - birds & beasts
fucked up - another day
KG&LW - Flight b741
death lens - cold world
i don't like mirrors - miserable false iden
duster - in dreams
the cactus blossoms - every time i think about you
aidan baker - cast down and hunted
real friends - blue hour
the dopamines - 80/20
Ὁπλίτης/Hoplites - Π​α​ρ​α​μ​α​ι​ν​ο​μ​έ​ν​η
Systems Officer - in our code
paysage d'hiver - die berge
moin - you never end

